1 1 1 1 1 1 1 1 1 1
1 0 0 0 0 0 0 0 0 1
1 0 0 1 0 0 0 0 2 1
1 0 0 1 0 0 0 0 0 1
1 0 0 1 0 0 0 0 0 1
1 0 0 1 0 0 0 0 0 1
1 0 0 1 0 0 0 0 1 1
1 0 0 0 0 0 0 0 0 1
1 0 0 0 0 0 0 0 0 1
1 1 1 1 1 1 1 1 1 1

!0start_pos_x: 5
!1start_pos_y: 5