2 2 2 2 2 2 2 2 2 2 2 2 2 2 2 2 2 2 2 2 2 2 2 2 2 2 2 2 2 2
2 0 0 3 0 0 0 0 0 0 0 0 3 0 0 0 0 0 0 0 0 0 0 0 0 0 0 0 0 2
2 0 0 3 0 0 0 3 3 0 3 3 3 5 0 0 0 4 0 0 0 3 0 0 0 0 0 0 0 2
2 0 0 3 0 0 0 3 0 0 0 0 0 0 0 0 0 0 0 0 0 0 0 0 0 0 0 0 4 2
2 0 0 3 0 0 0 3 0 0 4 0 5 0 0 0 4 0 0 0 3 0 0 0 0 0 0 0 0 2
2 0 0 3 0 0 0 3 0 0 4 0 0 0 0 0 0 0 0 0 0 0 0 0 0 0 0 4 0 2
2 0 0 0 0 0 0 3 0 0 4 0 0 0 0 0 0 0 0 0 0 0 0 0 0 0 0 0 0 2
2 0 0 3 3 3 3 3 0 0 4 0 0 5 0 0 0 4 0 0 0 3 0 2 0 0 0 0 0 2
2 0 0 3 0 0 0 0 0 0 4 0 0 0 0 0 0 0 0 0 0 0 0 0 0 0 0 0 4 2
2 0 0 3 0 0 0 0 0 0 5 0 0 0 4 0 0 0 3 0 0 0 2 0 0 0 0 0 0 2
2 0 0 3 5 0 5 0 5 0 4 0 0 7 0 0 6 0 0 0 0 0 0 0 0 4 0 0 0 2
2 3 3 3 0 0 0 0 0 0 4 0 0 7 0 0 6 0 0 0 0 0 0 0 0 0 0 0 0 2
2 0 0 0 0 4 4 4 4 4 4 0 0 7 0 0 6 0 0 0 0 0 0 2 0 0 0 0 0 2
2 0 0 0 0 4 0 0 0 0 0 0 0 7 0 0 6 0 0 0 0 0 0 0 0 0 0 0 0 2
2 0 0 0 0 4 0 0 0 0 0 0 0 7 0 0 6 0 0 0 2 0 0 0 0 0 0 0 0 2
2 0 0 0 0 4 0 0 0 0 0 0 0 0 0 0 0 9 0 0 0 0 0 8 0 0 0 0 0 2
2 0 0 0 0 0 0 0 0 0 0 0 0 0 0 0 0 0 0 0 0 0 0 0 0 0 0 0 0 2
2 0 0 0 0 0 0 0 0 0 0 0 0 0 0 0 9 0 0 0 0 0 8 0 0 0 0 0 0 2
2 0 0 0 0 0 0 0 0 0 0 8 0 0 0 0 0 0 0 0 0 0 0 0 0 0 0 0 0 2
2 0 0 0 0 0 0 0 0 0 0 8 0 0 0 0 0 0 0 0 6 0 0 0 0 0 0 0 3 2
2 0 0 0 0 0 0 0 0 0 0 8 0 0 0 0 0 9 0 0 0 0 0 8 0 0 0 0 0 2
2 0 0 0 0 0 0 0 0 0 0 8 0 0 0 0 0 0 0 6 0 0 0 0 0 0 0 3 0 2
2 0 0 0 0 0 0 0 0 0 0 8 0 0 9 0 0 0 0 0 8 0 0 0 0 0 0 0 0 2
2 0 0 0 0 0 0 0 0 0 0 0 0 0 0 0 0 0 0 0 0 0 0 0 0 0 0 0 0 2
2 0 0 0 0 0 0 0 0 0 0 0 0 0 0 0 0 0 0 0 6 0 0 0 0 0 0 0 3 2
2 0 0 0 0 0 0 0 0 0 0 0 0 0 0 0 0 0 0 0 0 0 0 0 0 0 0 0 0 2
2 0 0 0 0 0 0 0 0 0 0 0 0 0 0 0 0 6 0 0 0 0 0 0 0 3 0 0 0 2
2 0 0 0 0 0 0 0 0 0 0 0 0 0 0 0 0 0 0 0 0 0 0 0 0 0 0 0 0 2
2 0 0 0 0 0 0 0 0 0 0 0 0 0 0 0 0 0 0 0 0 0 0 0 0 0 0 0 0 2
2 2 2 2 2 2 2 2 2 2 2 2 2 2 2 2 2 2 2 2 2 2 2 2 2 2 2 2 2 2

!0start_pos_x: 2
!1start_pos_y: 2

!2texture: textures/wall1.xpm
!3texture: textures/wall2.xpm
!4texture: textures/wall3.xpm
!5texture: textures/wall4.xpm
!6texture: textures/wall5.xpm
!7texture: textures/wall6.xpm
!8texture: textures/wall7.xpm
!9texture: textures/wall8.xpm
